{
	"TILE_SIZE_2D" : 6,
	"LEVEL_MATRIX" : [
		[00,00,80,11,10,10,10,11,10,10,10,80,11,10,10,10,80,10],
		[00,00,10,10,11,80,10,10,11,10,10,81,10,10,10,10,10,80],
		[80,10,10,81,10,10,10,80,81,81,10,10,10,11,11,10,10,10],
		[80,10,11,11,10,11,10,10,11,11,11,10,10,10,11,11,10,10],
		[80,10,10,11,11,80,10,11,11,11,11,10,10,80,10,10,10,10],
		[81,10,10,11,10,11,11,10,10,11,11,11,11,10,11,10,10,10],
		[80,11,11,81,10,10,10,11,11,10,81,80,10,10,10,11,10,10],
		[81,11,19,10,11,10,80,11,11,10,10,11,11,10],
		[80,11,10,11,10,10,10,10,11,10,10,10,11,10],
		[80,11,11,11,11,11,11,10,10,10,80,11,81,10],
		[81,11,11,11,11,11,11,11,11,11,10,10,10,10],
		[80,10,10,80,80,80,80,80,80,80,80,81,10,10,10,10,10,88],
	],
}
