{
	"TILE_SIZE_2D" : 6,
	"LEVEL_MATRIX" : [
		[80,80,80,81,80,80,80,81,80,80,80,80,81,80,80,80,80,80],
		[80,80,80,80,81,80,80,80,81,80,80,81,80,80,80,80,80,80],
		[80,80,80,81,80,80,80,80,81,81,80,80,80,81,81,80,80,80],
		[80,80,81,81,80,81,80,80,81,81,81,80,80,80,81,81,80,80],
		[80,80,80,81,81,80,80,81,81,81,81,80,80,80,80,80,80,80],
		[81,80,80,81,80,81,81,80,80,81,81,81,81,80,81,80,80,80],
		[80,81,81,81,80,80,80,81,81,80,81,80,80,80,80,81,80,80],
		[81,81,81,80,81,80,80,81,81,80,80,81,81,80,80,80,80,81],
		[80,81,80,81,81,80,80,80,81,80,80,80,81,80,80,81,80,80],
		[80,81,81,81,81,81,81,80,80,80,80,81,81,81,81,81,80,80],
		[81,81,81,81,81,81,81,81,81,81,80,80,80,80,80,80,80,80],
		[80,80,80,80,80,80,80,80,80,80,80,81,81,81,81,81,81,81],
	]
}
