{
	"TILE_SIZE_2D" : 4,
	"LEVEL_MATRIX" : [
		[00,00,90,11,10,10,10,11,10,10,10,90,11,10,10,10,90,10],
		[00,00,10,10,11,90,10,10,11,10,10,80,10,10,10,10,10,90],
		[90,10,10,80,10,10,10,90,80,80,10,10,10,11,11,10,10,10],
		[90,10,11,11,10,11,10,10,11,11,11,10,10,10,11,11,10,10],
		[90,10,10,11,11,90,10,11,11,11,11,10,10,90,10,10,10,10],
		[80,10,10,11,10,11,11,10,10,11,11,11,11,10,11,10,10,10],
		[90,11,11,80,10,10,10,11,11,10,80,90,10,10,10,11,10,10],
		[80,11,19,10,11,10,90,11,11,10,10,11,11,10],
		[90,11,10,11,10,10,10,10,11,10,10,10,11,10],
		[90,11,11,11,11,11,11,10,10,10,90,11,80,10],
		[80,11,11,11,11,11,11,11,11,11,10,10,10,10],
		[90,10,10,90,90,90,90,90,90,90,90,80,10,10,10,10,10,88],
	],
}
