{
	"TILE_SIZE_2D" : 12,
	"LEVEL_MATRIX" : [
		[10,10,10,10,10,10,10,],
		[10,10,10,10,10,10,10,10],
		[10,10,10,10,60,10,10,10,10],
		[10,10,10,10,10,10,10,40,10,10,00,00,00,10,10,10,10],
		[70,10,10,10,10,10,10,10,10,10,10,10,10,10,10,10,10,88],
		[10,10,10,10,10,10,10,10,10,10,00,00,00,10,10,10,10],
		[10,10,30,10,10,10,10,10,10],
		[10,10,10,10,10,19,10,10],
		[10,10,10,10,10,10,10]
	]
}
