{
	"TILE_SIZE_2D" : 12,
	"LEVEL_MATRIX" : [
		[10,10,10,00,50,00,00,00,00,40],
		[10,20,30,00,00,00,70,80],
		[10,20,30,40,50,60,70,80],
		[10,20,30,40,50,60,70,80,10,20,30,40,50,60,70,80],
		[10,20,30,49,50,60,70,80,00,00,00,00,00,00,00,80],
		[10,20,30,40,50,60,70,80,10,20,30,40,50,60,70,80],
		[10,00,30,40,50,60,00,80],
		[10,20,30,40,00,60,70,80],
		[10,20,30,40,50,60,70,80],
		[10,20,30,40,50,60,70,80],
	]
}
