{
	"TILE_SIZE_2D" : 4,
	"LEVEL_MATRIX" : [
		[11,11,21,31],
		[10,10,10,10],
		[10,10,10,10],
		[10,10,19,10],
		[18],
		[10,10,10,10,10,10,10, 10, 10,10,10,10, 10, 10,10,10,10, 10, 10,10,10,10,10,10,10],
		[10,00,00,00,00,00,00, 00, 00,00,00,00, 00, 00,00,00,00, 00, 00,00,00,00,00,00,10],
		[10,00,90,90,90,90,90, 00, 90,90,90,90, 00, 00,90,90,00, 00, 90,90,90,90,90,00,10],
		[10,00,00,00,90,00,00, 00, 90,00,00,00, 00, 90,00,00,00, 00, 00,00,90,00,00,00,10],
		[10,00,00,00,90,00,00, 00, 90,90,90,00, 00, 00,90,90,00, 00, 00,00,90,00,00,00,10],
		[10,00,00,00,90,00,00, 00, 90,00,00,00, 00, 00,00,00,90, 00, 00,00,90,00,00,00,10],
		[10,00,00,00,90,00,00, 00, 90,90,90,90, 00, 00,90,90,00, 00, 00,00,90,00,00,00,10],
		[10,00,00,00,00,00,00, 00, 00,00,00,00, 00, 00,00,00,00, 00, 00,00,00,00,00,00,10],
		[10,10,10,10,10,10,10, 10, 10,10,10,10, 10, 10,10,10,10, 10, 10,10,10,10,10,10,10]
	]
}
