{
	"TILE_SIZE_2D" : 4,
	"LEVEL_MATRIX" : [
		[00,10,10,10,10,10,10,],
		[22,"03",10,10,10,10,10,10],
		[10,10,10,10,30,10,10,10,10],
		[10,10,10,00,00,00,00,00,32,00,00,00,00,10,10,10,10],
		[00,00,00,00,70,20,10,10,10,20,10,10,78,20,40,10,10,53],
		[00,00,00,00,10,10,10,10,00,00,00,00,00,10,10,10,10],
		[00,00,00,00,10,10,10,10,10],
		[00,00,00,00,10,10,10,10,10],
		[52,00,00,00,00,10,10,00,"09"]
	],
}
