{
	"TILE_SIZE_2D" : 12,
	"LEVEL_MATRIX" : [
		[10,20,30,40,50,60,70,80],
		[10,20,30,40,50,60,70,80],
		[10,20,30,40,50,60,70,80,10,20,30,40,50,60,70,80],
		[10,20,30,40,50,60,70,80],
		[10,20,30,40,50,60,70,80,10,20,30,40,50,60,70,80],
		[10,00,30,40,50,60,00,80],
		[10,20,30,40,00,60,70,80],
		[10,20,30,40,50,60,70,80],
		[10,20,30,40,50,60,70,80],
	]
}
