{
	"TILE_SIZE_2D" : 12,
	"LEVEL_MATRIX" : [
		[00,70,70,70,70,70,70,],
		[12,03,70,70,70,70,70,70],
		[70,70,70,70,30,70,70,70,70],
		[70,70,70,00,00,00,00,00,22,00,00,00,00,70,70,70,70],
		[00,00,00,00,60,10,70,70,70,10,70,70,68,10,30,70,70,43],
		[00,00,00,00,70,70,70,70,00,00,00,00,00,70,70,70,70],
		[00,00,00,00,70,70,70,70,70],
		[00,00,00,00,70,70,70,70,70],
		[52,00,00,00,00,70,70,00,09]
	],
}
